Language	Language (local)	Wiki
Afar	QafÃ¡r af	aa
Abkhazian	Ğ°Ô¥ÑÑˆÓ™Ğ°	ab
Acehnese	AcÃ¨h	ace
Adyghe	Ğ°Ğ´Ñ‹Ğ³Ğ°Ğ±Ğ·Ñ	ady
Afrikaans	Afrikaans	af
Akan	Akan	ak
Alemannic	Alemannisch	als
Altai	Ğ°Ğ»Ñ‚Ğ°Ğ¹ Ñ‚Ğ¸Ğ»	alt
Amharic	áŠ áˆ›áˆ­áŠ›	am
Amis	Pangcah	ami
Aragonese	aragonÃ©s	an
Anglo-Saxon	Ã†nglisc	ang
Arabic	Ø§Ù„Ø¹Ø±Ø¨ÙŠØ©	ar
Aramaic	ÜÜªÜ¡ÜÜ	arc
Moroccan Arabic	Ø§Ù„Ø¯Ø§Ø±Ø¬Ø©	ary
Egyptian Arabic	Ù…ØµØ±Ù‰	arz
Assamese	à¦…à¦¸à¦®à§€à¦¯à¦¼à¦¾	as
Asturian	asturianu	ast
Atikamekw	Atikamekw	atj
Avar	Ğ°Ğ²Ğ°Ñ€	av
Kotava	Kotava	avk
Awadhi	à¤…à¤µà¤§à¥€	awa
Aymara	Aymar aru	ay
Azerbaijani	azÉ™rbaycanca	az
South Azerbaijani	ØªÛ†Ø±Ú©Ø¬Ù‡	azb
Bashkir	Ğ±Ğ°ÑˆÒ¡Ğ¾Ñ€Ñ‚ÑĞ°	ba
Balinese	Basa Bali	ban
Bavarian	Boarisch	bar
Samogitian	Å¾emaitÄ—Å¡ka	bat-smg
Central Bikol	Bikol Central	bcl
Belarusian	Ğ±ĞµĞ»Ğ°Ñ€ÑƒÑĞºĞ°Ñ	be
Belarusian (TaraÅ¡kievica)	Ğ±ĞµĞ»Ğ°Ñ€ÑƒÑĞºĞ°Ñ (Ñ‚Ğ°Ñ€Ğ°ÑˆĞºĞµĞ²Ñ–Ñ†Ğ°)	be-tarask
Bulgarian	Ğ±ÑŠĞ»Ğ³Ğ°Ñ€ÑĞºĞ¸	bg
Bhojpuri	à¤­à¥‹à¤œà¤ªà¥à¤°à¥€	bh
Bislama	Bislama	bi
Banjar	Banjar	bjn
Pa'O	á€•á€¡á€­á€¯á€á€ºá‚á€˜á€¬á‚á€á€¬á‚	blk
Bambara	bamanankan	bm
Bengali	à¦¬à¦¾à¦‚à¦²à¦¾	bn
Tibetan	à½–à½¼à½‘à¼‹à½¡à½²à½‚	bo
Bishnupriya Manipuri	à¦¬à¦¿à¦·à§à¦£à§à¦ªà§à¦°à¦¿à¦¯à¦¼à¦¾ à¦®à¦£à¦¿à¦ªà§à¦°à§€	bpy
Breton	brezhoneg	br
Bosnian	bosanski	bs
Buginese	á¨…á¨” á¨•á¨˜á¨á¨—	bug
Buryat	Ğ±ÑƒÑ€ÑĞ°Ğ´	bxr
Catalan	catalÃ 	ca
Chavacano	Chavacano de Zamboanga	cbk-zam
Eastern Min	MÃ¬ng-dÄ•Ì¤ng-ngá¹³Ì„	cdo
Chechen	Ğ½Ğ¾Ñ…Ñ‡Ğ¸Ğ¹Ğ½	ce
Cebuano	Cebuano	ceb
Chamorro	Chamoru	ch
Choctaw	Chahta Anumpa	cho
Cherokee	á£á³á©	chr
Cheyenne	TsetsÃªhestÃ¢hese	chy
Kurdish (Sorani)	Ú©ÙˆØ±Ø¯ÛŒ	ckb
Corsican	corsu	co
Cree	NÄ“hiyawÄ“win / á“€á¦áƒá”­ááá£	cr
Crimean Tatar	qÄ±rÄ±mtatarca	crh
Czech	ÄeÅ¡tina	cs
Kashubian	kaszÃ«bsczi	csb
Old Church Slavonic	ÑĞ»Ğ¾Ğ²Ñ£Ğ½ÑŒÑĞºÑŠ / â°”â°â°‘â°‚â°¡â°â° â°”â°â°Ÿ	cu
Chuvash	Ñ‡Ó‘Ğ²Ğ°ÑˆĞ»Ğ°	cv
Welsh	Cymraeg	cy
Danish	dansk	da
Dagbani	dagbanli	dag
German	Deutsch	de
Dinka	ThuÉ”Å‹jÃ¤Å‹	din
Zazaki	Zazaki	diq
Lower Sorbian	dolnoserbski	dsb
Doteli	à¤¡à¥‹à¤Ÿà¥‡à¤²à¥€	dty
Dhivehi	Ş‹Ş¨ŞˆŞ¬Ş€Ş¨Ş„Ş¦ŞŞ°	dv
Dzongkha	à½‡à½¼à½„à¼‹à½	dz
Ewe	eÊ‹egbe	ee
Greek	Î•Î»Î»Î·Î½Î¹ÎºÎ¬	el
Emilian-Romagnol	emiliÃ n e rumagnÃ²l	eml
English	English	en
Esperanto	Esperanto	eo
Spanish	espaÃ±ol	es
Estonian	eesti	et
Basque	euskara	eu
Extremaduran	estremeÃ±u	ext
Persian	ÙØ§Ø±Ø³ÛŒ	fa
Fula	Fulfulde	ff
Finnish	suomi	fi
VÃµro	vÃµro	fiu-vro
Fijian	Na Vosa Vakaviti	fj
Faroese	fÃ¸royskt	fo
French	franÃ§ais	fr
Franco-ProvenÃ§al	arpetan	frp
North Frisian	Nordfriisk	frr
Friulian	furlan	fur
West Frisian	Frysk	fy
Irish	Gaeilge	ga
Gagauz	Gagauz	gag
Gan	è´›èª	gan
Guianan Creole	kriyÃ²l gwiyannen	gcr
Scottish Gaelic	GÃ idhlig	gd
Galician	galego	gl
Gilaki	Ú¯ÛŒÙ„Ú©ÛŒ	glk
Guarani	AvaÃ±e'áº½	gn
Konkani	à¤—à¥‹à¤‚à¤¯à¤šà¥€ à¤•à¥‹à¤‚à¤•à¤£à¥€ / GÃµychi Konknni	gom
Gorontalo	Bahasa Hulontalo	gor
Gothic	ğŒ²ğŒ¿ğ„ğŒ¹ğƒğŒº	got
Gujarati	àª—à«àªœàª°àª¾àª¤à«€	gu
Gungbe	gungbe	guw
Manx	Gaelg	gv
Hausa	Hausa	ha
Hakka	å®¢å®¶èª/Hak-kÃ¢-ngÃ®	hak
Hawaiian	HawaiÊ»i	haw
Hebrew	×¢×‘×¨×™×ª	he
Hindi	à¤¹à¤¿à¤¨à¥à¤¦à¥€	hi
Fiji Hindi	Fiji Hindi	hif
Hiri Motu	Hiri Motu	ho
Croatian	hrvatski	hr
Upper Sorbian	hornjoserbsce	hsb
Haitian Creole	KreyÃ²l ayisyen	ht
Hungarian	magyar	hu
Armenian	Õ°Õ¡ÕµÕ¥Ö€Õ¥Õ¶	hy
Western Armenian	Ô±Ö€Õ¥Ö‚Õ´Õ¿Õ¡Õ°Õ¡ÕµÕ¥Ö€Õ§Õ¶	hyw
Herero	Otsiherero	hz
Interlingua	interlingua	ia
Indonesian	Bahasa Indonesia	id
Interlingue	Interlingue	ie
Igbo	Igbo	ig
Nuosu	ê†‡ê‰™	ii
Inupiaq	IÃ±upiatun	ik
Ilokano	Ilokano	ilo
Ingush	Ğ³Ó€Ğ°Ğ»Ğ³Ó€Ğ°Ğ¹	inh
Ido	Ido	io
Icelandic	Ã­slenska	is
Italian	italiano	it
Inuktitut	áƒá“„á’ƒá‘á‘á‘¦/inuktitut	iu
Japanese	æ—¥æœ¬èª	ja
Jamaican Patois	Patois	jam
Lojban	la .lojban.	jbo
Javanese	Jawa	jv
Georgian	áƒ¥áƒáƒ áƒ—áƒ£áƒšáƒ˜	ka
Karakalpak	Qaraqalpaqsha	kaa
Kabyle	Taqbaylit	kab
Kabardian	Ğ°Ğ´Ñ‹Ğ³ÑĞ±Ğ·Ñ	kbd
Kabiye	KabÉ©yÉ›	kbp
Tyap	Tyap	kcg
Kongo	Kongo	kg
Kikuyu	GÄ©kÅ©yÅ©	ki
Kuanyama	Kwanyama	kj
Kazakh	Ò›Ğ°Ğ·Ğ°Ò›ÑˆĞ°	kk
Greenlandic	kalaallisut	kl
Khmer	á—á¶áŸá¶ááŸ’á˜áŸ‚áš	km
Kannada	à²•à²¨à³à²¨à²¡	kn
Korean	í•œêµ­ì–´	ko
Komi-Permyak	Ğ¿ĞµÑ€ĞµĞ¼ ĞºĞ¾Ğ¼Ğ¸	koi
Kanuri	kanuri	kr
Karachay-Balkar	ĞºÑŠĞ°Ñ€Ğ°Ñ‡Ğ°Ğ¹-Ğ¼Ğ°Ğ»ĞºÑŠĞ°Ñ€	krc
Kashmiri	à¤•à¥‰à¤¶à¥à¤° / Ú©Ù²Ø´ÙØ±	ks
Ripuarian	Ripoarisch	ksh
Kurdish (Kurmanji)	kurdÃ®	ku
Komi	ĞºĞ¾Ğ¼Ğ¸	kv
Cornish	kernowek	kw
Kyrgyz	ĞºÑ‹Ñ€Ğ³Ñ‹Ğ·Ñ‡Ğ°	ky
Latin	Latina	la
Ladino	Ladino	lad
Luxembourgish	LÃ«tzebuergesch	lb
Lak	Ğ»Ğ°ĞºĞºÑƒ	lbe
Lezgian	Ğ»ĞµĞ·Ğ³Ğ¸	lez
Lingua Franca Nova	Lingua Franca Nova	lfn
Luganda	Luganda	lg
Limburgish	Limburgs	li
Ligurian	Ligure	lij
Ladin	Ladin	lld
Lombard	lombard	lmo
Lingala	lingÃ¡la	ln
Lao	àº¥àº²àº§	lo
Northern Luri	Ù„ÛŠØ±ÛŒ Ø´ÙˆÙ…Ø§Ù„ÛŒ	lrc
Lithuanian	lietuviÅ³	lt
Latgalian	latgaÄ¼u	ltg
Latvian	latvieÅ¡u	lv
Madurese	MadhurÃ¢	mad
Maithili	à¤®à¥ˆà¤¥à¤¿à¤²à¥€	mai
Banyumasan	Basa Banyumasan	map-bms
Moksha	Ğ¼Ğ¾ĞºÑˆĞµĞ½ÑŒ	mdf
Malagasy	Malagasy	mg
Marshallese	Ebon	mh
Meadow Mari	Ğ¾Ğ»Ñ‹Ğº Ğ¼Ğ°Ñ€Ğ¸Ğ¹	mhr
MÄori	MÄori	mi
Minangkabau	Minangkabau	min
Macedonian	Ğ¼Ğ°ĞºĞµĞ´Ğ¾Ğ½ÑĞºĞ¸	mk
Malayalam	à´®à´²à´¯à´¾à´³à´‚	ml
Mongolian	Ğ¼Ğ¾Ğ½Ğ³Ğ¾Ğ»	mn
Meitei	ê¯ƒê¯¤ê¯‡ê¯© ê¯‚ê¯£ê¯Ÿ	mni
Mon	á€˜á€¬á€á€¬ á€™á€”á€º	mnw
Marathi	à¤®à¤°à¤¾à¤ à¥€	mr
Hill Mari	ĞºÑ‹Ñ€Ñ‹Ğº Ğ¼Ğ°Ñ€Ñ‹	mrj
Malay	Bahasa Melayu	ms
Maltese	Malti	mt
Muscogee	Mvskoke	mus
Mirandese	MirandÃ©s	mwl
Burmese	á€™á€¼á€”á€ºá€™á€¬á€˜á€¬á€á€¬	my
Erzya	ÑÑ€Ğ·ÑĞ½ÑŒ	myv
Mazanderani	Ù…Ø§Ø²ÙØ±ÙˆÙ†ÛŒ	mzn
Nauruan	Dorerin Naoero	na
Nahuatl	NÄhuatl	nah
Neapolitan	Napulitano	nap
Low German	PlattdÃ¼Ã¼tsch	nds
Dutch Low Saxon	Nedersaksies	nds-nl
Nepali	à¤¨à¥‡à¤ªà¤¾à¤²à¥€	ne
Newar	à¤¨à¥‡à¤ªà¤¾à¤² à¤­à¤¾à¤·à¤¾	new
Ndonga	Oshiwambo	ng
Nias	Li Niha	nia
Dutch	Nederlands	nl
Norwegian (Nynorsk)	norsk nynorsk	nn
Norwegian (BokmÃ¥l)	norsk	no
Novial	Novial	nov
N'Ko	ß’ßß	nqo
Norman	Nouormand	nrm
Northern Sotho	Sesotho sa Leboa	nso
Navajo	DinÃ© bizaad	nv
Chewa	Chi-Chewa	ny
Occitan	occitan	oc
Livvi-Karelian	livvinkarjala	olo
Oromo	Oromoo	om
Odia	à¬“à¬¡à¬¼à¬¿à¬†	or
Ossetian	Ğ¸Ñ€Ğ¾Ğ½	os
Punjabi	à¨ªà©°à¨œà¨¾à¨¬à©€	pa
Pangasinan	Pangasinan	pag
Kapampangan	Kapampangan	pam
Papiamento	Papiamentu	pap
Picard	Picard	pcd
Nigerian Pidgin	NaijÃ¡	pcm
Pennsylvania German	Deitsch	pdc
Palatinate German	PÃ¤lzisch	pfl
Pali	à¤ªà¤¾à¤²à¤¿	pi
Norfolk	Norfuk / Pitkern	pih
Polish	polski	pl
Piedmontese	PiemontÃ¨is	pms
Western Punjabi	Ù¾Ù†Ø¬Ø§Ø¨ÛŒ	pnb
Pontic Greek	Î Î¿Î½Ï„Î¹Î±ÎºÎ¬	pnt
Pashto	Ù¾ÚšØªÙˆ	ps
Portuguese	portuguÃªs	pt
Paiwan	pinayuanan	pwn
Quechua	Runa Simi	qu
Romansh	rumantsch	rm
Romani	romani Ähib	rmy
Kirundi	ikirundi	rn
Romanian	romÃ¢nÄƒ	ro
Aromanian	armÃ£neashti	roa-rup
Tarantino	tarandÃ­ne	roa-tara
Russian	Ñ€ÑƒÑÑĞºĞ¸Ğ¹	ru
Rusyn	Ñ€ÑƒÑĞ¸Ğ½ÑŒÑĞºÑ‹Ğ¹	rue
Kinyarwanda	Ikinyarwanda	rw
Sanskrit	à¤¸à¤‚à¤¸à¥à¤•à¥ƒà¤¤à¤®à¥	sa
Sakha	ÑĞ°Ñ…Ğ° Ñ‚Ñ‹Ğ»Ğ°	sah
Santali	á±¥á±Ÿá±±á±›á±Ÿá±²á±¤	sat
Sardinian	sardu	sc
Sicilian	sicilianu	scn
Scots	Scots	sco
Sindhi	Ø³Ù†ÚŒÙŠ	sd
Northern Sami	davvisÃ¡megiella	se
Sango	SÃ¤ngÃ¶	sg
Serbo-Croatian	srpskohrvatski / ÑÑ€Ğ¿ÑĞºĞ¾Ñ…Ñ€Ğ²Ğ°Ñ‚ÑĞºĞ¸	sh
Shilha	Taclá¸¥it	shi
Shan	á½á‚ƒá‚‡á€á‚ƒá‚‡á€á‚†á€¸	shn
Sinhalese	à·ƒà·’à¶‚à·„à¶½	si
Simple English	Simple English	simple
Slovak	slovenÄina	sk
Saraiki	Ø³Ø±Ø§Ø¦ÛŒÚ©ÛŒ	skr
Slovene	slovenÅ¡Äina	sl
Samoan	Gagana Samoa	sm
Inari Sami	anarÃ¢Å¡kielÃ¢	smn
Shona	chiShona	sn
Somali	Soomaaliga	so
Albanian	shqip	sq
Serbian	ÑÑ€Ğ¿ÑĞºĞ¸ / srpski	sr
Sranan Tongo	Sranantongo	srn
Swazi	SiSwati	ss
Sotho	Sesotho	st
Saterland Frisian	Seeltersk	stq
Sundanese	Sunda	su
Swedish	svenska	sv
Swahili	Kiswahili	sw
Silesian	Å›lÅ¯nski	szl
Sakizaya	Sakizaya	szy
Tamil	à®¤à®®à®¿à®´à¯	ta
Tayal	Tayal	tay
Tulu	à²¤à³à²³à³	tcy
Telugu	à°¤à±†à°²à±à°—à±	te
Tetum	tetun	tet
Tajik	Ñ‚Ğ¾Ò·Ğ¸ĞºÓ£	tg
Thai	à¹„à¸—à¸¢	th
Tigrinya	á‰µáŒáˆ­áŠ›	ti
Turkmen	TÃ¼rkmenÃ§e	tk
Tagalog	Tagalog	tl
Tswana	Setswana	tn
Tongan	lea faka-Tonga	to
Tok Pisin	Tok Pisin	tpi
Turkish	TÃ¼rkÃ§e	tr
Seediq	Seediq	trv
Tsonga	Xitsonga	ts
Tatar	Ñ‚Ğ°Ñ‚Ğ°Ñ€Ñ‡Ğ°/tatarÃ§a	tt
Tumbuka	chiTumbuka	tum
Twi	Twi	tw
Tahitian	reo tahiti	ty
Tuvan	Ñ‚Ñ‹Ğ²Ğ° Ğ´Ñ‹Ğ»	tyv
Udmurt	ÑƒĞ´Ğ¼ÑƒÑ€Ñ‚	udm
Uyghur	Ø¦Û‡ÙŠØºÛ‡Ø±Ú†Û• / Uyghurche	ug
Ukrainian	ÑƒĞºÑ€Ğ°Ñ—Ğ½ÑÑŒĞºĞ°	uk
Urdu	Ø§Ø±Ø¯Ùˆ	ur
Uzbek	oÊ»zbekcha/ÑĞ·Ğ±ĞµĞºÑ‡Ğ°	uz
Venda	Tshivenda	ve
Venetian	vÃ¨neto	vec
Veps	vepsÃ¤n kelâ€™	vep
Vietnamese	Tiáº¿ng Viá»‡t	vi
West Flemish	West-Vlams	vls
VolapÃ¼k	VolapÃ¼k	vo
Walloon	walon	wa
Waray	Winaray	war
Wolof	Wolof	wo
Wu	å´è¯­	wuu
Kalmyk	Ñ…Ğ°Ğ»ÑŒĞ¼Ğ³	xal
Xhosa	isiXhosa	xh
Mingrelian	áƒ›áƒáƒ áƒ’áƒáƒšáƒ£áƒ áƒ˜	xmf
Yiddish	×™×™Ö´×“×™×©	yi
Yoruba	YorÃ¹bÃ¡	yo
Zhuang	Vahcuengh	za
Zeelandic	ZeÃªuws	zea
Mandarin	ä¸­æ–‡	zh
Classical Chinese	æ–‡è¨€	zh-classical
Southern Min	BÃ¢n-lÃ¢m-gÃº	zh-min-nan
Cantonese	ç²µèª	zh-yue
Zulu	isiZulu	zu